ggallus_gene_ensembl	Chicken genes (bGalGal1.mat.broiler.GRCg7b)
hsapiens_gene_ensembl	Human genes (GRCh38.p14)
mmusculus_gene_ensembl	Mouse genes (GRCm39)
rnorvegicus_gene_ensembl	Norway rat - BN/NHsdMcwi genes (GRCr8)
drerio_gene_ensembl	Zebrafish genes (GRCz11)
cabingdonii_gene_ensembl	Abingdon island giant tortoise genes (ASM359739v1)
scaustralis_gene_ensembl	African ostrich genes (ASM69896v1)
vpacos_gene_ensembl	Alpaca genes (vicPac1)
mmmarmota_gene_ensembl	Alpine marmot genes (marMar2.1)
pformosa_gene_ensembl	Amazon molly genes (Poecilia_formosa-5.1.2)
bbbison_gene_ensembl	American bison genes (Bison_UMD1.0)
uamericanus_gene_ensembl	American black bear genes (ASM334442v1)
nvison_gene_ensembl	American mink genes (NNQGG.v01)
cdromedarius_gene_ensembl	Arabian camel genes (CamDro2)
uparryii_gene_ensembl	Arctic ground squirrel genes (ASM342692v1)
smerianae_gene_ensembl	Argentine black and white tegu genes (HLtupMer3)
dnovemcinctus_gene_ensembl	Armadillo genes (Dasnov3.0)
sformosus_gene_ensembl	Asian bonytongue genes (fSclFor1.1)
gmorhua_gene_ensembl	Atlantic cod genes (gadMor3.0)
charengus_gene_ensembl	Atlantic herring  genes (Ch_v2.0.2v2)
ssalar_gene_ensembl	Atlantic salmon genes (Ssal_v3.1)
cporosus_gene_ensembl	Australian saltwater crocodile genes (CroPor_comp1)
lbergylta_gene_ensembl	Ballan wrasse genes (BallGen_V1)
lcalcarifer_gene_ensembl	Barramundi perch genes (ASB_HGAPassembly_v1)
dleucas_gene_ensembl	Beluga whale genes (ASM228892v3)
spartitus_gene_ensembl	Bicolor damselfish genes (Stegastes_partitus-1.0.2)
rbieti_gene_ensembl	Black snub-nosed monkey genes (ASM169854v1)
bmusculus_gene_ensembl	Blue whale genes (mBalMus1.v2)
llaticaudata_gene_ensembl	Blue-ringed sea krait genes (latLat_1.0)
sbboliviensis_gene_ensembl	Bolivian squirrel monkey genes (SaiBol1.0)
ppaniscus_gene_ensembl	Bonobo genes (panpan1.1)
strutta_gene_ensembl	Brown trout genes (fSalTru1.1)
hburtoni_gene_ensembl	Burton's mouthbrooder genes (AstBur1.0)
ogarnettii_gene_ensembl	Bushbaby genes (OtoGar3)
cintestinalis_gene_ensembl	C.intestinalis genes (KH)
csavignyi_gene_ensembl	C.savignyi genes (CSAV 2.0)
celegans_gene_ensembl	Caenorhabditis elegans (Nematode, N2) genes (WBcel235)
btaurus_gene_ensembl	Cattle genes (ARS-UCD2.0)
cwagneri_gene_ensembl	Chacoan peccary genes (CatWag_v2_BIUU_UCD)
cgobio_gene_ensembl	Channel bull blenny genes (fCotGob3.1)
ipunctatus_gene_ensembl	Channel catfish genes (ASM400665v3)
ptroglodytes_gene_ensembl	Chimpanzee genes (Pan_tro_3.0)
cgchok1gshd_gene_ensembl	Chinese hamster CHOK1GS genes (CHOK1GS_HDv1)
osinensis_gene_ensembl	Chinese medaka genes (ASM858656v1)
psinensis_gene_ensembl	Chinese softshell turtle genes (PelSin_1.0)
otshawytscha_gene_ensembl	Chinook salmon genes (Otsh_v2.0)
atestudineus_gene_ensembl	Climbing perch genes (fAnaTes1.3)
aocellaris_gene_ensembl	Clown anemonefish genes (ASM2253959v1)
lchalumnae_gene_ensembl	Coelacanth genes (LatCha1)
okisutch_gene_ensembl	Coho salmon genes (Okis_V2)
falbicollis_gene_ensembl	Collared flycatcher genes (FicAlb1.5)
scanaria_gene_ensembl	Common canary genes (SCA1)
cccarpio_gene_ensembl	Common carp genes (Cypcar_WagV4.0)
pmuralis_gene_ensembl	Common wall lizard genes (PodMur_1.0)
vursinus_gene_ensembl	Common wombat genes (bare-nosed_wombat_genome_assembly)
pcoquereli_gene_ensembl	Coquerel's sifaka genes (Pcoq_1.0)
mfascicularis_gene_ensembl	Crab-eating macaque genes (Macaca_fascicularis_6.0)
odegus_gene_ensembl	Degu genes (OctDeg1.0)
dclupeoides_gene_ensembl	Denticle herring genes (fDenClu1.2)
cldingo_gene_ensembl	Dingo genes (ASM325472v1)
clfamiliaris_gene_ensembl	Dog genes (ROS_Cfam_1.0)
ttruncatus_gene_ensembl	Dolphin genes (turTru1)
fcatus_gene_ensembl	Domestic cat genes (F.catus_Fca126_mat1.0)
bgrunniens_gene_ensembl	Domestic yak genes (LU_Bosgru_v3.0)
easinus_gene_ensembl	Donkey genes (ASM1607732v2)
mleucophaeus_gene_ensembl	Drill genes (Mleu.le_1.0)
dmelanogaster_gene_ensembl	Drosophila melanogaster (Fruit fly) - GCA_000001215.4 [FlyBase annotation] genes (BDGP6.54)
applatyrhynchos_gene_ensembl	Duck genes (CAU_duck1.0)
ptextilis_gene_ensembl	Eastern brown snake genes (EBS10Xv2-PRI)
acalliptera_gene_ensembl	Eastern happy genes (fAstCal1.3)
eelectricus_gene_ensembl	Electric eel genes (fEleEle1.pri)
lafricana_gene_ensembl	Elephant genes (Loxafr3.0)
cmilii_gene_ensembl	Elephant shark genes (Callorhinchus_milii-6.1.3)
svulgaris_gene_ensembl	Eurasian red squirrel genes (mSciVul1.1)
dlabrax_gene_ensembl	European seabass genes (dlabrax2021)
mpfuro_gene_ensembl	Ferret genes (MusPutFur1.0)
trubripes_gene_ensembl	Fugu genes (fTakRub1.2)
amelanoleuca_gene_ensembl	Giant panda genes (ASM200744v2)
nleucogenys_gene_ensembl	Gibbon genes (Nleu_3.0)
saurata_gene_ensembl	Gilthead seabream genes (fSpaAur1.1)
chircus_gene_ensembl	Goat genes (ARS1)
mauratus_gene_ensembl	Golden Hamster genes (MesAur1.0)
acchrysaetos_gene_ensembl	Golden eagle genes (bAquChr1.2)
rroxellana_gene_ensembl	Golden snub-nosed monkey genes (Rrox_v1)
cauratus_gene_ensembl	Goldfish genes (ASM336829v1)
gevgoodei_gene_ensembl	Goodes thornscrub tortoise genes (rGopEvg1_v1.p)
ggorilla_gene_ensembl	Gorilla genes (gorGor4)
pmajor_gene_ensembl	Great Tit genes (Parus_major1.1)
sdumerili_gene_ensembl	Greater amberjack genes (Sdu_1.0)
psimus_gene_ensembl	Greater bamboo lemur genes (Prosim_1.0)
rferrumequinum_gene_ensembl	Greater horseshoe bat genes (mRhiFer1_v1.p)
acarolinensis_gene_ensembl	Green anole genes (AnoCar2.0v2)
cporcellus_gene_ensembl	Guinea Pig genes (Cavpor3.0)
preticulata_gene_ensembl	Guppy genes (Guppy_female_1.0_MT)
eburgeri_gene_ensembl	Hagfish genes (Eburgeri_3.2)
eeuropaeus_gene_ensembl	Hedgehog genes (eriEur1)
ecaballus_gene_ensembl	Horse genes (EquCab3.0)
hhucho_gene_ensembl	Huchen genes (ASM331708v1)
bihybrid_gene_ensembl	Hybrid - Bos Indicus genes (UOA_Brahman_1)
pcapensis_gene_ensembl	Hyrax genes (proCap1)
nnaja_gene_ensembl	Indian cobra genes (Nana_v5)
omelastigma_gene_ensembl	Indian medaka genes (Om_v0.7.RACA)
olatipes_gene_ensembl	Japanese medaka HdrR genes (ASM223467v1)
cjaponica_gene_ensembl	Japanese quail genes (Coturnix_japonica_2.0)
ojavanicus_gene_ensembl	Javanese ricefish genes (OJAV_1.1)
shabroptila_gene_ensembl	Kakapo genes (bStrHab1_v1.p)
dordii_gene_ensembl	Kangaroo rat genes (Dord_2.0)
pcinereus_gene_ensembl	Koala genes (phaCin_unsw_v4.1)
pmarinus_gene_ensembl	Lamprey genes (Pmarinus_7.0)
lcrocea_gene_ensembl	Large yellow croaker genes (L_crocea_2.0)
lleishanense_gene_ensembl	Leishan spiny toad genes (ASM966780v1)
ppardus_gene_ensembl	Leopard genes (PanPar1.0)
jjaculus_gene_ensembl	Lesser Egyptian jerboa genes (JacJac1.0)
etelfairi_gene_ensembl	Lesser hedgehog tenrec genes (TENREC)
pleo_gene_ensembl	Lion genes (PanLeo1.0)
clanigera_gene_ensembl	Long-tailed chinchilla genes (ChiLan1.0)
clumpus_gene_ensembl	Lumpfish genes (fCycLum1.pri)
nbrichardi_gene_ensembl	Lyretail cichlid genes (NeoBri1.0)
anancymaae_gene_ensembl	Ma's night monkey genes (Anan_2.0)
mmulatta_gene_ensembl	Macaque genes (Mmul_10)
nscutatus_gene_ensembl	Mainland tiger snake genes (TS10Xv2-PRI)
pnyererei_gene_ensembl	Makobe Island cichlid genes (PunNye1.0)
aplatyrhynchos_gene_ensembl	Mallard genes (ASM874695v1)
kmarmoratus_gene_ensembl	Mangrove rivulus genes (ASM164957v1)
gfortis_gene_ensembl	Medium ground-finch genes (GeoFor_1.0)
pvampyrus_gene_ensembl	Megabat genes (pteVam1)
amexicanus_gene_ensembl	Mexican tetra genes (Astyanax_mexicanus-2.0)
mlucifugus_gene_ensembl	Microbat genes (Myoluc2.0)
acitrinellus_gene_ensembl	Midas cichlid genes (Midas_v5)
xcouchianus_gene_ensembl	Monterrey platyfish genes (Xiphophorus_couchianus-4.0.1)
mmurinus_gene_ensembl	Mouse Lemur genes (Mmur_3.0)
fheteroclitus_gene_ensembl	Mummichog genes (Fundulus_heteroclitus-3.0.2)
hgfemale_gene_ensembl	Naked mole-rat female genes (Naked_mole-rat_maternal)
mmonoceros_gene_ensembl	Narwhal genes (NGI_Narwhal_1)
oniloticus_gene_ensembl	Nile tilapia genes (O_niloticus_UMD_NMBU)
pmbairdii_gene_ensembl	Northern American deer mouse genes (HU_Pman_2.1)
elucius_gene_ensembl	Northern pike genes (fEsoLuc1.pri)
panubis_gene_ensembl	Olive baboon genes (Panubis1.0)
mdomestica_gene_ensembl	Opossum genes (ASM229v1)
apercula_gene_ensembl	Orange clownfish genes (Nemo_v1)
cpbellii_gene_ensembl	Painted turtle genes (Chrysemys_picta_bellii-3.0.3)
cimitator_gene_ensembl	Panamanian white-faced capuchin genes (Cebus_imitator-1.0)
pkingsleyae_gene_ensembl	Paramormyrops kingsleyae genes (PKINGS_0.1)
ssbamei_gene_ensembl	Pig - Bamei genes (Bamei_pig_v1)
ssberkshire_gene_ensembl	Pig - Berkshire genes (Berkshire_pig_v1)
sshampshire_gene_ensembl	Pig - Hampshire genes (Hampshire_pig_v1)
ssjinhua_gene_ensembl	Pig - Jinhua genes (Jinhua_pig_v1)
sslandrace_gene_ensembl	Pig - Landrace genes (Landrace_pig_v1)
sslargewhite_gene_ensembl	Pig - Largewhite genes (Large_White_v1)
ssmeishan_gene_ensembl	Pig - Meishan genes (Meishan_pig_v1)
sspietrain_gene_ensembl	Pig - Pietrain genes (Pietrain_pig_v1)
ssrongchang_gene_ensembl	Pig - Rongchang genes (Rongchang_pig_v1)
sstibetan_gene_ensembl	Pig - Tibetan genes (Tibetan_Pig_v2)
sswuzhishan_gene_ensembl	Pig - Wuzhishan genes (minipig_v1.0)
ssusmarc_gene_ensembl	Pig USMARC genes (USMARCv1.0)
sscrofa_gene_ensembl	Pig genes (Sscrofa11.1)
mnemestrina_gene_ensembl	Pig-tailed macaque genes (Mnem_1.0)
oprinceps_gene_ensembl	Pika genes (OchPri2.0-Ens)
slucioperca_gene_ensembl	Pike-perch genes (SLUC_FBN_1)
mmurdjan_gene_ensembl	Pinecone soldierfish genes (fMyrMur1.1)
abrachyrhynchus_gene_ensembl	Pink-footed goose genes (ASM259213v1)
xmaculatus_gene_ensembl	Platyfish genes (X_maculatus-5.0-male)
oanatinus_gene_ensembl	Platypus genes (mOrnAna1.p.v1)
umaritimus_gene_ensembl	Polar bear genes (UrsMar_1.0)
mochrogaster_gene_ensembl	Prairie vole genes (MicOch1.0)
ocuniculus_gene_ensembl	Rabbit genes (OryCun2.0)
omykiss_gene_ensembl	Rainbow trout genes (USDA_OmykA_1.1)
vvulpes_gene_ensembl	Red fox genes (VulVul2.2)
pnattereri_gene_ensembl	Red-bellied piranha genes (fPygNat1.pri)
ecalabaricus_gene_ensembl	Reedfish genes (fErpCal1.1)
mcaroli_gene_ensembl	Ryukyu mouse genes (CAROLI_EIJ_v1.1)
scerevisiae_gene_ensembl	Saccharomyces cerevisiae genes (R64-1-1)
platipinna_gene_ensembl	Sailfin molly genes (P_latipinna-1.0)
oaries_gene_ensembl	Sheep (texel) genes (Oar_v3.1)
oarambouillet_gene_ensembl	Sheep genes (ARS-UI_Ramb_v2.0)
cvariegatus_gene_ensembl	Sheepshead minnow genes (C_variegatus-1.0)
saraneus_gene_ensembl	Shrew genes (sorAra1)
mpahari_gene_ensembl	Shrew mouse genes (PAHARI_EIJ_v1.1)
bsplendens_gene_ensembl	Siamese fighting fish genes (fBetSpl5.2)
mmoschiferus_gene_ensembl	Siberian musk deer genes (MosMos_v2_BIUU_UCD)
choffmanni_gene_ensembl	Sloth genes (choHof1)
catys_gene_ensembl	Sooty mangabey genes (Caty_1.0)
pcatodon_gene_ensembl	Sperm whale genes (ASM283717v2)
apolyacanthus_gene_ensembl	Spiny chromis genes (ASM210954v1)
loculatus_gene_ensembl	Spotted gar genes (LepOcu1)
itridecemlineatus_gene_ensembl	Squirrel genes (SpeTri2.0)
mspicilegus_gene_ensembl	Steppe mouse genes (MUSP714)
gaculeatus_gene_ensembl	Stickleback genes (GAculeatus_UGA_version5)
pabelii_gene_ensembl	Sumatran orangutan genes (Susie_PABv2)
csyrichta_gene_ensembl	Tarsier genes (Tarsius_syrichta-2.0.1)
sharrisii_gene_ensembl	Tasmanian devil genes (mSarHar1.11)
tnigroviridis_gene_ensembl	Tetraodon genes (TETRAODON 8.0)
tctriunguis_gene_ensembl	Three-toed box turtle genes (T_m_triunguis-2.0)
ptaltaica_gene_ensembl	Tiger genes (PanTig1.0)
hcomes_gene_ensembl	Tiger tail seahorse genes (H_comes_QL1_v1)
csemilaevis_gene_ensembl	Tongue sole genes (Cse_v1.0)
tbelangeri_gene_ensembl	Tree Shrew genes (tupBel1)
xtropicalis_gene_ensembl	Tropical clawed frog genes (UCB_Xtro_10.0)
spunctatus_gene_ensembl	Tuatara genes (ASM311381v1)
smaximus_gene_ensembl	Turbot genes (ASM1334776v1)
mgallopavo_gene_ensembl	Turkey genes (Turkey_5.1)
nfurzeri_gene_ensembl	Turquoise killifish genes (Nfu_20140520)
ngalili_gene_ensembl	Upper Galilee mountains blind mole rat genes (S.galili_v1.0)
psinus_gene_ensembl	Vaquita genes (mPhoSin1.pri)
csabaeus_gene_ensembl	Vervet-AGM genes (ChlSab1.1)
neugenii_gene_ensembl	Wallaby genes (Meug_1.0)
mspretus_gene_ensembl	Western wild mouse genes (SPRET_EiJ_v3)
cjacchus_gene_ensembl	White-tufted-ear marmoset genes (mCalJac1.pat.X)
bmutus_gene_ensembl	Wild yak genes (BosGru_v2.0)
chyarkandensis_gene_ensembl	Yarkand deer genes (CEY_v1)
sldorsalis_gene_ensembl	Yellowtail amberjack genes (Sedor1)
tguttata_gene_ensembl	Zebra finch genes (bTaeGut1_v1.p)
mzebra_gene_ensembl	Zebra mbuna genes (M_zebra_UMD2a)
marmatus_gene_ensembl	Zig-zag eel genes (fMasArm1.2)
